Andaman_&_Nicobar_Islands	Veer_Savarkar_International_Airport	Port_Blair	Customs
Andhra_Pradesh	Visakhapatnam_Airport	Visakhapatnam	Customs
Assam	Lokpriya_Gopinath_Bordoloi_International_Airport	Guwahati	Customs
Assam Silchar_Airport Silchar Domestic
Bihar	Jaiprakash_Narayan_International_Airport	Patna	Customs
Chandigarh Chandigarh_International_Airport Chandigarh Domestic
Chhattisgarh	Swami_Vivekananda_Airport	Raipur	Domestic
Delhi	Indira_Gandhi_International_Airport	Delhi	International
Goa	Dabolim_Airport Goa	International
Gujarat	Sardar_Vallabhbhai_Patel_International_Airport	Ahmedabad	International
Gujarat Rajkot_Airport	Rajkot		Domestic
Gujarat Civil_Aerodrome	Vadodara Domestic
Jammu_and_Kashmir	Srinagar_Airport	Srinagar	Custom
Karnataka	Mangalore_Airport	Mangalore	Customs
Karnataka Bengaluru_International_Airport_(Kempegowda)	Bengaluru	International
Kerala	Trivandrum_International_Airport	Trivandrum	International
Kerala 	Cochin_International_Airport	Kochi	International
Madhya_Pradesh	Raja_Bhoj_Airport	Bhopal	Customs
Madhya_Pradesh 	Devi_Ahilyabai_Holkar_Airport	Indore	Domestic
Maharashtra	Chhatrapati_Shivaji_International_Airport	Mumbai	International
Maharashtra 	Pune_Airport	Pune	Customs
Maharashtra 	Dr._Babasaheb_Ambedkar_International_Airport	Nagpur	Customs
Manipur Tulihal_Airport	Imphal	Domestic
Mizoram Lengpui_Airport	Aizawl	Domestic
Odisha Patnaik_Airport	Bhubaneswar	Domestic
Punjab Sri_Guru_Ram_Dass_Jee_International_Airport	Amritsar	International
Rajasthan	Jaipur_International_Airport	Jaipur	Customs
Rajasthan  Jodhpur_Airport	Jodhpur		Domestic
Rajasthan  Maharana_Pratap_Airport	Udaipur		Domestic
Tamil_Nadu	Chennai_International_Airport	Chennai	International
Tamil_Nadu    Coimbatore_International_Airport 	Coimbatore  Domestic
Tamil_Nadu 	Madurai_Airport	 Madurai  Domestic
Tamil_Nadu 	Tiruchirapalli_International_Airport	Tiruchirapally	Customs
Telangana	Rajiv_Gandhi_International_Airport	Hyderabad	International
Tripura	Agartala_Airport	Agartala	Domestic
Uttrakhand	Jolly_Grant_Airport	Dehradun	Domestic
Uttar_Pradesh 	Varanasi_Airport	Varanasi	Customs
Uttar_Pradesh 	Amausi_Airport	Lucknow	Customs
West_Bengal	Netaji_Subhash_Chandra_Bose_International_Airport	Kolkata	International
West_Bengal	Bagdogra_Airport	Bagdogra	Customs